Abdulkareem	Abdulazeem	5
Aitanov	Ariet	5
Akgul	Iclal	5
Amelchanka	Alesia	5
Assanov	Bereke	5
Aydemir	Halit	5
Ayd?n	Betul	5
Bakhtiyorov	Bunyod	5
Baktybek	Gulzina	5
Balaban	Ivan	5
Bassie	Hailegebriel	5
Bhandari	Abhishek	5
Bise	Jacob	5
Chen	Zhe	5
Chinhamora	Brian	5
Christmas	Manatsaishe	5
Chupryna	Valentyn	5
Dodkhoev	Muhammadosim	5
Erdem	Sena	5
Ersan	Sena	5
Fantu	Abenezer	5
Gabongwe	Courtney	5
Gas?mov	Mammadiyya	5
Gedik	Hayrettin	5
Gojayev	Murad	5
gumbanjera	joey	5
Gwati	Brendon	5
Gwiza	Tapiwa	5
Hnennyi	Illia	5
Hrebeniuk	Maksym	5
Iatsuk	Damir	5
Iksanova	Sabina	5
Izmalkov	Denys	5
Jasani	Kaushal	5
Kadamov	Azizbek	5
Kaddouri	Walid	5
Katena	Wesley	5
Khakimov	Javokhir	5
Khodjamov	Umidjon	5
Kilic	Efe	5
Ledwaba	Ebube	5
Mandimutsira	Craig	5
Mantsho	Tshego	5
Markeliuk	Tymofii	5
Marocha	Joe	5
Mazivanhanga	Tatenda	5
Meshcheriakova	Myroslava	5
Molife	Dumo	5
Mpala	Mbonisi	5
Mpofu	Bakhile	5
Murotov	Shakhzod	5
Musariri	Tanaka	5
Muswe	Gladys	5
Mutendwa	Panashe	5
Muvandi	Takunda	5
Namashamov	Kurmanbek	5
Njela	Tapiwanashe	5
Nuray	�mer	5
Nyamayaro	Thomas	5
Nyamkondiwa	Sean	5
Ognianyk	Pavlo	5
Onal	Emirhan	5
�zbilenler	Asl?han	5
Ozcan	Beng?su	5
Ozturk	Enes	5
Pal	Chandroja	5
Parlak	Muhammed	5
Ponomarenko	Oleksandr	5
Proskuryakov	Nikita	5
Radoman	Maksim	5
Rahimli	Orkhan	5
Rakhmanberdiev	Dinislam	5
Rudenko	Vladyslav	5
Samir	Mohamed	5
Suleymanov	Mahammad	5
Sultanov	Ernis	5
Thomas	Bijin	5
Tilniak	Nikita	5
Toroev	Umar	5
Tymofiichuk	Andrii	5
Unal	Bahtiyar	5
Zamirbek	Aiperi	5
Zhamaitsiak	Daniil	5
Zhenishov	Aziret	5
Zhyrnyi	Oleh	5
Zihumo	Munashe	5
Zvobgo	Prince	5
